sl-79
4K Investments	4K Investments	ORG	ORG-4K-Invest
AA International Aviation Holding	AA International Aviation Holding	ORG	ORG-AA-International-Aviation-Holding
Abu Dabija	Abu Dabi	LOC	GPE-Abu-Dhabi
Adia Airways	Adria Airways	ORG	ORG-Adria-Airways
Adria Airways	Adria Airways	ORG	ORG-Adria-Airways
Adria	Adria	ORG	ORG-Adria-Airways
Adrie Airways	Adria Airways	ORG	ORG-Adria-Airways
Adrii	Adria	ORG	ORG-Adria-Airways
Adriia Airways	Adria Airways	ORG	ORG-Adria-Airways
Adriji	Adria	ORG	ORG-Adria-Airways
Adrijinih	Adria	ORG	ORG-Adria-Airways
Adrio	Adria	ORG	ORG-Adria-Airways
Air Serbia	Air Serbia	ORG	ORG-Air-Serbia
Alitalii	Alitalia	ORG	ORG-Alitalia
Beograd	Beograd	LOC	GPE-Belgrade
Beogradu	Beograd	LOC	GPE-Belgrade
Bruslja	Bruselj	LOC	GPE-Brussles
Bruslju	Bruselj	LOC	GPE-Brussles
Delo	Delo	ORG	ORG-Delo
Dragan Gajin	Dragan Gajin	PER	PER-Dragan-Gajin
EU	EU	ORG	ORG-European-Union
Etihad	Etihad	ORG	ORG-Etihad-Airways
Evropska komisija	Evropska komisija	ORG	ORG-European-Commission
Evropske komisije	Evropska komisija	ORG	ORG-European-Commission
Evropski komisiji	Evropska komisija	ORG	ORG-European-Commission
Frankfurt	Frankfurt	LOC	GPE-Frankfurt-am-Main
Gajinovih	Gajin	PER	PER-Dragan-Gajin
Holger Kowarsch	Holger Kowarsch	PER	PER-Holger-Kowarsch
Italiji	Italija	LOC	GPE-Italy
Ljubljana	Ljubljana	LOC	GPE-Ljubljana
Ljubljane	Ljubljana	LOC	GPE-Ljubljana
München	München	LOC	GPE-Munich
Niš	Niš	LOC	GPE-Niš
Podgorica	Podgorica	LOC	GPE-Podgorica
Priština	Priština	LOC	GPE-Prishtina
Ryanair	Ryanair	ORG	ORG-Ryanair
STA	STA	ORG	ORG-Slovenian-Press-Agency
Sarajevo	Sarajevo	LOC	GPE-Sarajevo
Siol	Siol	ORG	ORG-Siol
Siolu	Siol	ORG	ORG-Siol
Skopje	Skopje	LOC	GPE-Skopje
Srbiji	Srbija	LOC	GPE-Serbia
Tirana	Tirana	LOC	GPE-Tirana
Twitterju	Twitter	PRO	PRO-Twitter
Violeta Bulc	Violeta Bulc	PER	PER-Violeta-Bulc
Zürich	Zürich	LOC	GPE-Zürich
zahodnega Balkana	zahodni Balkan	LOC	LOC-Western-Balkans
