bg_3001_2
Renaissance Education Foundation в Лахор	Renaissance Education Foundation в Лахор	ORG	ORG-Renaissance-Education-Foundation
Азия Биби	Азия Биби	PER	PER-Asia-Bibi
Азия	Азия	PER	PER-Asia-Bibi
Ашик Масих	Ашик Масих	PER	PER-Ashiq-Masih
Ашик	Ашик	PER	PER-Ashiq-Masih
Бог	Бог	PER	PER-God
Боко Харам	Боко Харам	ORG	ORG-Boko-Haram
Ватикана	Ватикана	LOC	GPE-Vatican
Върховния съд на Лахор	Върховен съд на Лахор	ORG	ORG-Lahore-High-Court
Върховният съд на Пакистан	Върховен съд на Пакистан	ORG	ORG-Supreme-Court-of-Pakistan
Годжра	Годжра	LOC	GPE-Gojra
Джоузеф Колони	Джоузеф Колони	PER	PER-Joseph-Colony
Ейшам Асик	Ейшам Асик	PER	PER-Eisham-Ashiq
Ейшам	Ейшам	PER	PER-Esham-Masih
Исламабад	Исламабад	LOC	GPE-Islamabad
Италия	Италия	LOC	GPE-Italy
Итанвали	Итанвали	LOC	GPE-Ittanwali
Кадим Хюсеин Ризви	Кадим Хюсеин Ризви	PER	PER-Khadim-Hussain-Rizvi
Мохамед	Мохамед	PER	PER-Prophet-Muhammad
Мултан	Мултан	LOC	GPE-Multan
Пакистан	Пакистан	LOC	GPE-Pakistan
Помощ за страдащата Църква	Помощ за страдащата Църква	ORG	ORG-ACN-Aid-to-the-Church-in-Need
Пунджаб	Пунджаб	LOC	GPE-Punjab
Ребека	Ребека	PER	PER-Rebecca-Bitrus
Рим	Рим	LOC	GPE-Rome
Сайфул Малук	Сайфул Малук	PER	PER-Saif-Ul-Malook
Свети отче	Свят отец	PER	PER-Pope-Francis
Светия отец	Свят отец	PER	PER-Pope-Francis
Светла Чалъкова	Светла Чалъкова	PER	PER-Svetla-Chalakova
Техриик-е-Лабайк Пакистан	Техриик-е-Лабайк Пакистан	ORG	ORG-Tehreek-e-Labbaik-Pakistan
Франциск	Франциск	PER	PER-Pope-Francis
Христа	Христос	PER	PER-Jesus-Christ
Юсеф Надиим	Юсеф Надиим	PER	PER-Joseph-Nadeem
