bg_3070_2
 Ажа	Ажа	PER	PER-Asia-Bibi
 Джеръми Рейнълдс	Джеръми Рейнълдс	PER	PER-Jeremy-Reynolds
 Сайфул Малук	Сайфул Малук	PER	PER-Saif-Ul-Malook
ASSIST News Service	ASSIST News Service	ORG	ORG-Bibby-Financial-Services
Ажа Биби	Ажа Биби	PER	PER-Asia-Bibi
Ажа	Ажа	PER	PER-Asia-Bibi
Ашик Масих	Ашик Масих	PER	PER-Ashiq-Masih
Ашик	Ашик	PER	PER-Ashiq-Masih
Бог	Бог	PER	PER-God
Възраждане на образованието	Възраждане на образованието	ORG	ORG-Renaissance-Education-Foundation
Върховният съд на Пакистан	Върховен съд на Пакистан	ORG	ORG-Supreme-Court-of-Pakistan
Гил	Гил	PER	PER-Sajjad-Masih-Gill
Годината на милосърдието	Годината на милосърдието	EVT	EVT-Jubilee-Year-of-Mercy
Джоузеф Надийм	Джоузеф Надийм	PER	PER-Joseph-Nadeem
Иисус Христос	Иисус Христос	PER	PER-Jesus-Christ
Иисус	Иисус	PER	PER-Jesus-Christ
Карачи	Карачи	LOC	GPE-Karachi
Ла Стампа	Ла Стампа	PRO	PRO-La-Stampa
Лахор	Лахор	LOC	GPE-Lahore
Мамнун Хюсеин	Мамнун Хюсеин	PER	PER-Mamnoon-Hussain
Мохамед	Мохамед	PER	PER-Prophet-Muhammad
Мултан	Мултан	LOC	GPE-Multan
Нисар Шар	Нисар Шар	PER	PER-Nisar-Shar
Пакистан	Пакистан	LOC	GPE-Pakistan
Паоло Афатато	Паоло Афатато	PER	PER-Paolo-Affatato
Пенджаб	Пенджаб	LOC	GPE-Punjab
Рождество Христово	Рождество Христово	EVT	EVT-Christmas
Рождество	Рождество	EVT	EVT-Christmas
Саджад Масих Гил	Саджад Масих Гил	PER	PER-Sajjad-Masih-Gill
Синдху	Синдху	PER	PER-Khalil-Tahir-Sindhu
Торино	Торино	LOC	GPE-Torino
Халил Тахир Синдху	Халил Тахир Синдху	PER	PER-Khalil-Tahir-Sindhu
Хюсеин	Хюсеин	PER	PER-Mamnoon-Hussain
