sl-119
AP	AP	ORG	ORG-AP-The-Associated-Press
Abu Ibrahim al Hašemi al Kuraši	Abu Ibrahim al Hašemi al Kuraši	PER	PER-Abu-Ibrahim-al-Hashimi-al-Qurashi
Abuja Bakra al Bagdadija	Abu Bakr al Bagdadi	PER	PER-Abu-Bakr-al-Baghdadi
Azaz	Azaz	LOC	GPE-Azaz
BBC	BBC	ORG	ORG-BBC-Ltd
Bagdadi	Bagdadi	PER	PER-Abu-Bakr-al-Baghdadi
Bagdadijeva	Bagdadi	PER	PER-Abu-Bakr-al-Baghdadi
Bagdadijeve	Bagdadi	PER	PER-Abu-Bakr-al-Baghdadi
Bagdadijevo	Bagdadi	PER	PER-Abu-Bakr-al-Baghdadi
Donald Trump	Donald Trump	PER	PER-Donald-Trump
Fahrettin Altun	Fahrettin Altun	PER	PER-Fahrettin-Altun
Hudson	Hudson	ORG	ORG-Hudson-institute
IS	IS	ORG	ORG-ISIS-Islamic-State-of-Iraq-and-the-Levant
Iraka	Irak	LOC	GPE-Iraq
Iraku	Irak	LOC	GPE-Iraq
Islamska država	Islamska država	ORG	ORG-ISIS-Islamic-State-of-Iraq-and-the-Levant
Mike Pregent	Mike Pregent	PER	PER-Mike-Pergent
New York Times	New York Times	ORG	ORG-New-York-Times
Rasmijo Avad	Rasmija Avad	PER	PER-Rasmiya-Awad
Sirije	Sirija	LOC	GPE-Syria
Siriji	Sirija	LOC	GPE-Syria
Turčija	Turčija	LOC	GPE-Turkey
