sl-107
All-Star	All-Star	EVT	EVT-NBA-All-Star-Game
Američane	Američani	PER	GPE-USA
Atlanta Hawks	Atlanta Hawks	ORG	ORG-Atlanta-Hawks
B en Simmons	Ben Simmons	PER	PER-Ben-Simmons
Cuban	Cuban	PER	PER-Mark-Cuban
Dallasa	Dallas	LOC	GPE-Dallas
Dallasu	Dallas	LOC	GPE-Dallas
Deandreja Aytona	DeAndre Ayton	PER	PER-DeAndre-Ayton
Dennisa Smitha	Dennis Smith	PER	PER-Dennis-Smith
Dončić	Dončić	PER	PER-Luka-Dončić
Dončića	Dončić	PER	PER-Luka-Dončić
Dončićem	Dončić	PER	PER-Luka-Dončić
Dončič	Dončić	PER	PER-Luka-Dončić
ESPN	ESPN	ORG	ORG-Entertainment-and-Sports-Programming-Network
ESPY nagrad za najbolj prodornega športnika	ESPY nagrade za najbolj prodornega športnika	PRO	PRO-Excellence-in-Sports-Performance-Yearly-Award
Evropi	Evropa	LOC	LOC-Europe
Giannisom	Giannis	PER	PER-Antetokounmpo-Giannis
Igor Kokoškov	Igor Kokoškov	PER	PER-Igor-Kokoškov
LA-ju	LA	LOC	GPE-Los-Angeles
Larryju Birdu	Larry Bird	PER	PER-Larry-Bird
LeBronom	LeBron	PER	PER-LeBron-James
LeBronu Jamesu	LeBron James	PER	PER-LeBron-James
Ljubljane	Ljubljana	LOC	GPE-Ljubljana
Ljubljančan	Ljubljančan	PER	GPE-Ljubljana
Los Angelesu	Los Angeles	LOC	GPE-Los-Angeles
Luka Dončić	Luka Dončić	PER	PER-Luka-Dončić
Luka	Luka	PER	PER-Luka-Dončić
Magica Johnsona	Magic Johnson	PER	PER-Magic-Johnson
Magicu Johnsonu	Magic Johnson	PER	PER-Magic-Johnson
Mark Cuban	Mark Cuban	PER	PER-Mark-Cuban
Markelle Fultz	Markelle Fultz	PER	PER-Markelle-Fultz
Mavericks	Mavericks	ORG	ORG-Dallas-Mavericks
Mavs	Mavs	ORG	ORG-Dallas-Mavericks
Michaelu Jordanu	Michael Jordan	PER	PER-Michael-Jordan
NBA	NBA	ORG	ORG-National-Basketbal-Associaton
Oscarju Robertsonu	Oscar Robertson	PER	PER-Oscar-Robertson
Pauu Gasolu	Pau Gasol	PER	PER-Pau-Gasol
Phoenixa	Phoenix	LOC	GPE-Phoenix
Rick Carlisle	Rick Carlisle	PER	PER-Rick-Carlisle
Robertson	Robertson	PER	PER-Ian-Robertson
S haquille O’Neal	Shaquille O’Neal	PER	PER-Shaquille-O'Neal
Sacramento Kings	Sacramento Kings	ORG	ORG-Kings-College
Santa Monici	Santa Monica	LOC	GPE-Santa-Monica
TNT	TNT	PRO	PRO-Turner-Network-Television
Trae Young	Trae Young	PER	PER-Trae-Young
Treaja Younga	Trae Young	PER	PER-Trae-Young
Young	Young	PER	PER-Trae-Young
ZDA	ZDA	LOC	GPE-USA
Zahodu	Zahod	LOC	LOC-West
tekmo All-Star	tekma All-Star	EVT	EVT-NBA-All-Star-Game
