sl-40
Baltika	Baltik	LOC	LOC-Baltic-Sea
Baltskega morja	Baltsko morje	LOC	LOC-Baltic-Sea
EU	EU	ORG	ORG-European-Union
Evroposlanci	evroposlanci	PER	ORG-European-Parliament
Evropske unije	Evropska unija	ORG	ORG-European-Union
Evropski parlament	Evropski parlament	ORG	ORG-European-Parliament
Evropski poslanci	Evropski poslanci	PER	ORG-European-Parliament
Grčija	Grčija	LOC	GPE-Greece
Iran	Iran	LOC	GPE-Iran
Libija	Libija	LOC	GPE-Libya
Makedonija	Makedonija	LOC	GPE-Northern-Macedonia
Prespanskemu sporazumu	Prespanski sporazum	PRO	PRO-Prespa-Agreement
Rusija	Rusija	LOC	GPE-Russia
Rusije	Rusija	LOC	GPE-Russia
Rusiji	Rusija	LOC	GPE-Russia
Rusijo	Rusija	LOC	GPE-Russia
Severna Koreja	Severna Koreja	LOC	GPE-North-Korea
Severni tok 2	Severni tok 2	PRO	PRO-Nord-Stream-2
Sirija	Sirija	LOC	GPE-Syria
Siriji	Sirija	LOC	GPE-Syria
Srednjeafriška republika	Srednjeafriška republika	LOC	GPE-Central-African-Republic
Sredozemlja	Sredozemlje	LOC	LOC-Mediterranean-Sea
Ukrajini	Ukrajina	LOC	GPE-Ukraine
Venezuela	Venezuela	LOC	GPE-Venezuela
sporazuma iz Minska	sporazum iz Minska	PRO	PRO-Minsk-Protocol
vzhodni Ukrajini	vzhodna Ukrajina	LOC	LOC-East-Ukraine
Črnega morja	Črno morje	LOC	LOC-Black-Sea
