sl-202
Covid-19	covid-19	PRO	64-0
Slovenci	Slovenec	PER	xxx
Srečkom Šestanom Srečko Šestan	Srečko Šestan Srečko Šestan	PER	xxx
Civilne zaščite	civilen zaščita	ORG	64-4
Leon Vidic	Leon Vidic	PER	xxx
Delo	delo	ORG	xxx
Srečko Šestan	Srečko Šestan	PER	xxx
Sloveniji Šestan	Slovenija Šestan	LOC	xxx
Hrvaškem	Hrvaško	LOC	327-1
Hrvatih	Hrvat	PER	327-7
Italiji	Italija	LOC	290-3
Italije	Italija	LOC	290-3
zakonu o nalezljivih bolezni	zakon o nalezljiv bolezen	PRO	xxx
Civilna zaščita	civilen zaščita	ORG	64-4
Kitajske	Kitajska	LOC	xxx
Italijo	Italija	LOC	290-3
Kitajski	Kitajski	LOC	xxx
Kitajcem	Kitajec	PER	xxx
Slovenije	Slovenija	LOC	xxx
Kitajci zaščita zdravje	Kitajec zaščita zdravje	PER	xxx
Janez Janša	Janez Janša	PER	321-7
Svet za nacionalno varnost križ	svet za nacionalen varnost križ	ORG	xxx
Metliki	Metlika	LOC	255-12
Sloveniji	Slovenija	LOC	xxx
Matej Tonin	Matej Tonin	PER	255-27
migrantsko	migrantski	EVT	xxx
