ru-145
Асия Биби	Асия Биби	PER	PER-Asia-Bibi
Асия Норин	Асия Норин	PER	PER-Asia-Bibi
Асия	Асия	PER	PER-Asia-Bibi
Биби	Биби	PER	PER-Asia-Bibi
Верховного суда	Верховный суд	ORG	ORG-Supreme-Court-of-Pakistan
Имрана Хана	Имран Хан	PER	PER-Imran-Khan
Исламабад-Равалпинди	Исламабад-Равалпинди	LOC	LOC-Islamabad-Rawalpindi-Road
Исламабад	Исламабад	LOC	GPE-Islamabad
Иттан Вали	Иттан Вали	LOC	GPE-Ittanwali
Карачи	Карачи	LOC	GPE-Karachi
Лахора	Лахор	LOC	GPE-Lahore
Пакистана	Пакистан	LOC	GPE-Pakistan
Пакистане	Пакистан	LOC	GPE-Pakistan
Панджаб	Панджаб	LOC	GPE-Punjab
Пешаваре	Пешавар	LOC	GPE-Peshawar
Пророка	Пророк	PER	PER-Prophet-Muhammad
Техрик-э-Лабайк Пакистан	Техрик-э-Лабайк Пакистан	ORG	ORG-Tehreek-e-Labbaik-Pakistan
Хадим Резви	Хадим Резви	PER	PER-Khadim-Hussain-Rizvi
Хадим Хусейн Ризви	Хадим Хусейн Ризви	PER	PER-Khadim-Hussain-Rizvi
