sl-133
Argentino	Argentina	LOC	GPE-Argentina
Clintonovi	Clinton	PER	PER-Hillary-Clinton
Cohen	Cohen	PER	PER-Michael-Cohen
Cohena	Cohen	PER	PER-Michael-Cohen
Cohenov	Cohen	PER	PER-Michael-Cohen
Cohenovem	Cohen	PER	PER-Michael-Cohen
Cohenovo	Cohen	PER	PER-Michael-Cohen
Comeyja	Comey	PER	PER-James-Comey
Donald Trump	Donald Trump	PER	PER-Donald-Trump
Donalda Trumpa	Donald Trump	PER	PER-Donald-Trump
FBI	FBI	ORG	ORG-FBI-Federal-Bureau-of-Investigation
G20	G20	ORG	ORG-G20
Hillary Clinton	Hillary Clinton	PER	PER-Hillary-Clinton
Jamesa Comeyja	James Comey	PER	PER-James-Comey
Josepha McCarthyja	Joseph McCarthy	PER	PER-Joseph-McCarthy
Karen McDougal	Karen McDougal	PER	PER-Karen-McDougal
Manaforta	Manafort	PER	PER-Paul-Manafort
Manafortom	Manafort	PER	PER-Paul-Manafort
Mark Warner	Mark Warner	PER	PER-Mark-Warner
Melanio	Melania	PER	PER-Melania-Trump
Michael Cohen	Michael Cohen	PER	PER-Michael-Cohen
Moskvi	Moskva	LOC	GPE-Moscow
Mueller	Mueller	PER	PER-Robert-Mueller
Muellerja	Mueller	PER	PER-Robert-Mueller
Muellerjevi	Mueller	PER	PER-Robert-Mueller
Paul Manafort	Paul Manafort	PER	PER-Paul-Manafort
Playboyjevem	Playboy	ORG	ORG-Playboy
Robertom Muellerjem	Robert Mueller	PER	PER-Robert-Mueller
Roger Stone	Roger Stone	PER	PER-Roger-Stone
Rusi	Rusi	PER	GPE-Russia
Rusiji	Rusija	LOC	GPE-Russia
Rusijo	Rusija	LOC	GPE-Russia
Stormy Daniels	Stormy Daniels	PER	PER-Stormy-Daniels
Trump	Trump	PER	PER-Donald-Trump
Trumpa	Trump	PER	PER-Donald-Trump
Trumpom	Trump	PER	PER-Donald-Trump
Trumpov	Trump	PER	PER-Donald-Trump
Trumpov	Trumpov	PER	PER-Donald-Trump
Trumpove	Trump	PER	PER-Donald-Trump
Trumpovega	Trump	PER	PER-Donald-Trump
Trumpovi	Trump	PER	PER-Donald-Trump
Trumpovih	Trump	PER	PER-Donald-Trump
Trumpovim	Trump	PER	PER-Donald-Trump
Ukrajini	Ukrajina	LOC	GPE-Ukraine
Virginije	Virginija	LOC	LOC-Virginia
Wikileaksom	Wikileaks	PRO	PRO-Wikileaks
ZDA	ZDA	LOC	GPE-USA
demokrat	demokrat	PER	ORG-Democratic-Party-USA
demokrati	demokrati	ORG	ORG-Democratic-Party-USA
demokratov	demokrati	ORG	ORG-Democratic-Party-USA
senatnem odboru za obveščevalne zadeve	senatni odbor za obveščevalne zadeve	ORG	ORG-United-States-Senate-Select-Committee-on-Intelligence
zveznem sodišču v New Yorku	zvezno sodišče v New Yorku	LOC	ORG-Judiciary-of-New-York
