sl-6
ALUO	ALUO	ORG	ORG-Academy-of-Fine-Arts-and-Design-Ljubljana
Akademije za likovno umetnost in oblikovanje	Akademija za likovno umetnost in oblikovanje	ORG	ORG-Academy-of-Fine-Arts-and-Design-Ljubljana
Akademijo za likovno umetnost in oblikovanje	Akademija za likovno umetnost in oblikovanje	ORG	ORG-Academy-of-Fine-Arts-and-Design-Ljubljana
Andraža Moharja	Andraž Mohar	PER	PER-Andraž-Mohar
Andreja Kamnika	Andrej Kamnik	PER	PER-Andrej-Kamnik
Anne Elisabeth Tassel	Anna Elisabeth Tassel	PER	PER-Anna-Elisabeth-Tassel
Barbare Miše	Barbara Miše	PER	PER-Barbara-Miše
Bibi Erjavec	Bibi Erjavec	PER	PER-Bibi-Erjavec
Ivana Kobilca	Ivana Kobilca	PER	PER-Ivana-Kobilca
Ivane Kobilca	Ivana Kobilca	PER	PER-Ivana-Kobilca
Ivane Kobilce	Ivana Kobilca	PER	PER-Ivana-Kobilca
Ivane Kobilica	Ivana Kobilca	PER	PER-Ivana-Kobilca
Klara Jan	Klara Jan	PER	PER-Klara-Jan
Kofetarica	Kofetarica	PRO	PRO-Kofetarica
Kofetarice	Kofetarica	PRO	PRO-Kofetarica
Kofetarico	Kofetarica	PRO	PRO-Kofetarica
Kongresnem trgu	Kongresni trg	LOC	LOC-Congress-Square
Lare Batistuta	Lara Batistuta	PER	PER-Lara-Batistuta
Ljubljane	Ljubljana	LOC	GPE-Ljubljana
Loka kava	Loka kava	ORG	ORG-Loka-Coffee
Loka kave	Loka kava	ORG	ORG-Loka-Coffee
Loka kave	Loka kava	PRO	PRO-Loka-Coffee
Loka kavi	Loka kava	ORG	ORG-Loka-Coffee
Loke kave	Loka kava	ORG	ORG-Loka-Coffee
Narodno galerijo	Narodna galerija	LOC	LOC-National-Gallery-of-Slovenia
Oddelka za oblikovanje vizualnih komunikacij	Oddelek za oblikovanje vizualnih komunikacij	ORG	ORG-Department-for-Visual-Communications-Design
Oddelka za slikarstvo	Oddelek za slikarstvo	ORG	ORG-Department-for-Painting
Petja Grafenauer	Petja Grafenauer	PER	PER-Petja-Grafenauer
Sara Sešlar Naraks	Sara Sešlar Naraks	PER	PER-Sara-Sešlar-Naraks
Saša Sedlačka	Sašo Sedlaček	PER	PER-Sašo-Sedlaček
Slovenskem	Slovensko	LOC	GPE-Slovenia
Sodobna kofetarica	Sodobna kofetarica	EVT	EVT-Sodobna-Kofetarica
Sodobna kofetarica	Sodobna kofetarica	PRO	PRO-Sodobna-Kofetarica
Sodobne kofetarice	Sodobna kofetarica	PRO	PRO-Sodobna-Kofetarica
Sodobno kofetarico	Sodobna kofetarica	EVT	EVT-Sodobna-Kofetarica
Suzi Bricelj	Suzi Bricelj	PER	PER-Suzi-Bricelj
Tine Sapundžić	Tina Sapundžić	PER	PER-Tina-Sapundžić
Univerze v Ljubljani	Univerza v Ljubljani	ORG	ORG-University-of-Ljubljana
Valentine Agostini	Valentina Agostini	PER	PER-Valentina-Agostini
Veronika Hozjan	Veronika Hozjan	PER	PER-Veronika-Hozjan
Zagreb	Zagreb	LOC	GPE-Zagreb
Žige Kariža	Žiga Kariž	PER	PER-Žiga-Kariž
