84
Ноември	ноември	EVT	xxx
Агенция Монитор	агенция монитор	ORG	xxx
Джо Байдън	джо байдън	PER	xxx
Пенсилвания	пенсилвания	LOC	xxx
Избирателна колегия	избирателен колегия	ORG	xxx
BBC	bbc	ORG	xxx
CNN	cnn	ORG	xxx
Fox News	fox news	ORG	xxx
Associated Press	associated press	ORG	xxx
Барак Обама	барак обама	PER	xxx
САЩ	сащ	LOC	xxx
Байдън	байдън	PER	xxx
Twitter	twitter	PRO	xxx
Харис	харис	PER	xxx
Америка	америка	LOC	xxx
Камала Харис	камала харис	PER	xxx
Великобритания	великобритания	LOC	xxx
Борис Джонсън	борис джонсън	PER	xxx
Франция	франция	LOC	xxx
Еманюел Макрон	еманюел макрон	PER	xxx
Михол Мартин	михол мартин	PER	xxx
Гърция	гърция	LOC	xxx
Кириакос Мицотакис	кириакос мицотакис	PER	xxx
Австрия	австрия	LOC	xxx
Себастиан Курц	себастиан курц	PER	xxx
Германия	германия	LOC	xxx
Хайко Маас	хайко маас	PER	xxx
ЕК	ек	ORG	xxx
Урсула фон дер Лайен	урсула фон дер лайен	PER	xxx
Ангела Меркел	ангела меркел	PER	xxx
Тръмп	тръмп	PER	xxx
Ройтерс	ройтерс	ORG	xxx
Руди Джулиани	руди джулиани	PER	xxx
ДПА	дпа	ORG	xxx
Ню Йорк	ню йорк	LOC	xxx
Вашингтон	вашингтон	LOC	xxx
Белия дом	бял дом	LOC	xxx
Филаделфия	филаделфия	LOC	xxx
