28
Соломон Паси	соломон паси	PER	xxx
Америка	америка	LOC	xxx
САЩ	сащ	LOC	xxx
Втората световна война	втори световен война	EVT	xxx
bTV	bTV	PRO	xxx
Джо Байдън	джо байдън	PER	xxx
Съединените щати	съединя-(се) щат	LOC	xxx
Паси	паси	PER	xxx
Тръмп	тръмп	PER	xxx
Близкия изток	близък изток	LOC	xxx
Израел	израел	LOC	xxx
Бахрейн	бахрейн	LOC	xxx
Обединените арабски емирства	обединя-(се) арабски емирство	LOC	xxx
Судан	судан	LOC	xxx
Обама	обама	PER	xxx
5 G	5 ветър	PRO	xxx
Китай	китай	LOC	xxx
Байдън	байдън	PER	xxx
НАТО	нато	ORG	xxx
Вашингтон	вашингтон	LOC	xxx
България	българия	LOC	xxx
Европейския съюз	европейски съюз	ORG	xxx
Три морета	три море	PRO	xxx
