66
САЩ	сащ	LOC	xxx
Републиканската партия	републикански партия	ORG	xxx
Сената	сено	ORG	xxx
демократи	демократ	PER	xxx
Демократическата партия	демократически партия	ORG	xxx
Синята вълна	син вълна	PRO	xxx
Колорадо	колорадо	LOC	xxx
Алабама	алабама	LOC	xxx
Мичиган	мичиган	LOC	xxx
Аризона	аризона	LOC	xxx
сенатори	сенатор	PER	xxx
Джорджия	джорджия	LOC	xxx
Рафаел Уарнок	рафаел уарнок	PER	xxx
Кели Лофлер	кели лофлер	PER	xxx
Джо Байдън	джо байдън	PER	xxx
Белия дом	бял дом	LOC	xxx
Байдън	байдън	PER	xxx
Доналд Тръмп	доналд тръмп	PER	xxx
Марта МакСали	марта максали	PER	xxx
Кори Гарднър	кори гарднър	PER	xxx
Марк Кели	марк кели	PER	xxx
Джон Хикенлопър	джон хикенлопър	PER	xxx
републиканци	републиканец	PER	xxx
Мич Макконъл	мич макконъл	PER	xxx
Линдзи Греъм	линдзи греъм	PER	xxx
