29
Байдън	байдън	PER	xxx
Доналд Тръмп	доналд тръмп	PER	xxx
битката Вашингтон с Пекин	битка вашингтон с пекин	EVT	xxx
Джо Байдън	джо байдън	PER	xxx
Ройтерс	ройтерс	ORG	xxx
Тръмп	тръмп	PER	xxx
Китай	китай	LOC	xxx
Фан Синдун	фан синдун	PER	xxx
Университета по комуникации на Джеян	университет по комуникация на джеян	ORG	xxx
Съединените щати	съединя-(се) щат	LOC	xxx
Фан	фан	PER	xxx
САЩ	сащ	LOC	xxx
Huawei Technologies	huawei technologies	ORG	xxx
TikTok	tiktok	ORG	xxx
ByteDance	bytedance	ORG	xxx
Tencent Holdings	tencent holdings	ORG	xxx
Вашингтон	вашингтон	LOC	xxx
Huawei	huawei	ORG	xxx
Walmart	walmart	ORG	xxx
Oracle	oracle	ORG	xxx
Jefferies	reuuerie	ORG	xxx
Пекин	пекин	LOC	xxx
