50
Байдън	байдън	PER	xxx
Тръмп	тръмп	PER	xxx
САЩ	сащ	LOC	xxx
Джо Байдън	джо байдън	PER	xxx
Доналд Тръмп	доналд тръмп	PER	xxx
РИА Новости	риа новост	ORG	xxx
Джорджия	джорджия	LOC	xxx
COVID-19	covid-19	PRO	xxx
Сената	сено	ORG	xxx
Интерфакс	интерфакс	ORG	xxx
Джон Ософ	джон ософ	PER	xxx
Рафаел Уорнок	рафаел уорнок	PER	xxx
Джон	джон	PER	xxx
Рафаел	рафаел	PER	xxx
Вашингтон	вашингтон	LOC	xxx
Ософ	ософ	PER	xxx
Уорнок	уорнок	PER	xxx
Дейвид Пърдю	дейвид пърдю	PER	xxx
Кели Лефлър	кели лефлър	PER	xxx
Конгреса	конгрес	ORG	xxx
