35
САЩ	сащ	LOC	xxx
Байдън	байдън	PER	xxx
Тръмп	тръмп	PER	xxx
Доналд Тръмп	доналд тръмп	PER	xxx
туит	туит	EVT	xxx
Twitter	twitter	PRO	xxx
Администрацията за общи услуги	администрация за общ услуга	ORG	xxx
GSA	gsa	ORG	xxx
Емили Мърфи	емили мърфи	PER	xxx
Мърфи	мърфи	ORG	xxx
Джо Байдън	джо байдън	PER	xxx
Емили	емили	PER	xxx
EPA	epa	ORG	xxx
Джанет Йелън	джанет йелън	PER	xxx
Путин	путин	PER	xxx
Fox News	fox news	PRO	xxx
Руди Джулиани	руди джулиани	PER	xxx
Белия дом	бял дом	LOC	xxx
Джон Болтън	джон болтън	PER	xxx
Handelsblatt	handelsblatt	PRO	xxx
Болтън	болтън	PER	xxx
Сидни Пауъл	сидни пауъл	PER	xxx
Джулиани	джулиани	PER	xxx
Куба	куба	LOC	xxx
Венецуела	венецуела	LOC	xxx
Китай	китай	LOC	xxx
Уго Чавес	уго чавес	PER	xxx
Германия	германия	LOC	xxx
Мичиган	мичиган	LOC	xxx
Америка	америка	LOC	xxx
“	“	LOC	xxx
Европа	европа	LOC	xxx
