13
Brexit	brexit	EVT	xxx
Великобритания	великобритания	LOC	xxx
САЩ	сащ	LOC	xxx
Париж	париж	LOC	xxx
Берлин	берлин	LOC	xxx
Европа	европа	LOC	xxx
Вашингтон	вашингтон	LOC	xxx
Джо Байдън	джо байдън	PER	xxx
Обединеното кралство	обединя-(се) кралство	LOC	xxx
НАТО	нато	ORG	xxx
Питър Рикетс	питър рикетс	PER	xxx
Байдън	байдън	PER	xxx
Америка	америка	LOC	xxx
Politico	politico	PRO	xxx
Лондон	лондон	LOC	xxx
Дейвид Камерън	дейвид камерън	PER	xxx
Белия дом	бял дом	LOC	xxx
Айвън Роджърс	айвън роджърс	PER	xxx
ЕС	ес	ORG	xxx
Рикетс	рикетс	PER	xxx
Ирландия	ирландия	LOC	xxx
Брюксел	брюксел	LOC	xxx
Даунинг стрийт	даунинг стрийт	LOC	xxx
консервативната партия	консервативен партия	ORG	xxx
Джонсън	джонсън	PER	xxx
Ангела Меркел	ангела меркел	PER	xxx
Еманюел Макрон	еманюел макрон	PER	xxx
