45
САЩ	сащ	LOC	xxx
Байдън	байдън	PER	xxx
Тръмп	тръмп	PER	xxx
Белия дом	бял дом	LOC	xxx
Джо Байдън	джо байдън	PER	xxx
Мичиган	мичиган	LOC	xxx
Уисконсин	уисконсин	LOC	xxx
Асошиейтед прес	асошиейтед прес	ORG	xxx
Аризона	аризона	LOC	xxx
Невада	невада	LOC	xxx
Северна Каролина	северен каролина	LOC	xxx
Джорджия	джорджия	LOC	xxx
Пенсилвания	пенсилвания	LOC	xxx
Доналд Тръмп	доналд тръмп	PER	xxx
Кентъки	кентъки	LOC	xxx
Канзас	канзас	LOC	xxx
Луизиана	луизиана	LOC	xxx
Флорида	флорида	LOC	xxx
Тексас	тексас	LOC	xxx
Уайоминг	уайоминг	LOC	xxx
Западна Вирджиния	западен вирджиния	LOC	xxx
Южна Каролина	южен каролина	LOC	xxx
Алабама	алабама	LOC	xxx
Мисисипи	мисисипи	LOC	xxx
Тенеси	тенеси	LOC	xxx
Оклахома	оклахома	LOC	xxx
Арканзас	арканзас	LOC	xxx
Северна Дакота	северен дакота	LOC	xxx
Южна Дакота	южен дакота	LOC	xxx
Айдахо	айдахо	LOC	xxx
Небраска	небраска	LOC	xxx
Юта	юта	LOC	xxx
Охайо	охайо	LOC	xxx
Мисури	мисури	LOC	xxx
Айова	айова	LOC	xxx
Монтана	монтана	LOC	xxx
Индиана	индиана	LOC	xxx
Колорадо	колорадо	LOC	xxx
Ню Мексико	ню мексико	LOC	xxx
Върмонт	върмонт	LOC	xxx
Вирджиния	вирджиния	LOC	xxx
Роуд Айланд	роуд айланд	LOC	xxx
Ню Йорк	ню йорк	LOC	xxx
Ню Джърси	ню джърси	LOC	xxx
Масачузетс	масачузетс	LOC	xxx
Мериленд	мериленд	LOC	xxx
Илинойс	илинойс	LOC	xxx
Делауеър	делауеър	LOC	xxx
Кънектикът	кънектик	LOC	xxx
Минесота	минесота	LOC	xxx
Хаваи	хаваи	LOC	xxx
Федерален окръг Колумбия	федерален окръг колумбия	LOC	xxx
Ню Хемпшир	ню хемпшир	LOC	xxx
Калифорния	калифорния	LOC	xxx
Ореган	ореган	LOC	xxx
Вашингтон	вашингтон	LOC	xxx
Мейн	мейн	LOC	xxx
