99
САЩ	сащ	LOC	xxx
Доналд Тръмп	доналд тръмп	PER	xxx
Фигаро	фигаро	PRO	xxx
Републиканската партия	републикански партия	ORG	xxx
Джорджия	джорджия	LOC	xxx
Сената	сенат	ORG	xxx
Джо Байдън	джо байдън	PER	xxx
Телеграф	телеграф	PRO	xxx
БТА	бта	ORG	xxx
Тръмп	тръмп	PER	xxx
Монд	монд	PRO	xxx
Майк Пенс	майк пенс	PER	xxx
Конгреса	конгрес	ORG	xxx
Байдън	байдън	PER	xxx
Дейли мейл	дейли мейл	PRO	xxx
Пенс	пенс	PER	xxx
сенатори	сенатор	PER	xxx
Гардиън	гардиън	PRO	xxx
Америка	америка	LOC	xxx
Ню Йорк таймс	ню йорк таймс	PRO	xxx
Камарата на представителите	камара на представител	ORG	xxx
Novini.bg	novini.bg	PRO	xxx
