24
Facebook	facebook	PRO	xxx
Байдън	байдън	PER	xxx
Марк Зукърбърг	марк зукърбърг	PER	xxx
Джо Байдън	джо байдън	PER	xxx
Съединените щати	съединя-(се) щат	LOC	xxx
CNBC	cnbc	PRO	xxx
Зукърбърг	зукърбърг	PER	xxx
BuzzFeed	buzzfeed	PRO	xxx
Тръмп	тръмп	PER	xxx
“	“	PER	xxx
Доналд Тръмп	доналд тръмп	PER	xxx
САЩ	сащ	LOC	xxx
Instagram	instagram	PRO	xxx
Стив Банън	стив банън	PER	xxx
Ройтерс	ройтерс	ORG	xxx
Банън	банън	PER	xxx
ФБР	фбр	ORG	xxx
Кристофър Рей	кристофър рей	PER	xxx
Антъни Фаучи	антъни фаучи	PER	xxx
Белия дом	бял дом	LOC	xxx
