75
Тръмп	тръмп	PER	xxx
Байдън	байдън	PER	xxx
САЩ	сащ	LOC	xxx
NOVA	nova	PRO	xxx
Алън Лихтман	алън лихтман	PER	xxx
Рейгън	рейгън	PER	xxx
Лихтман	лихтман	PER	xxx
Белия дом	бял дом	LOC	xxx
Роналд Рейгън	роналд рейгън	PER	xxx
Голямата депресия	голям депресия	EVT	xxx
Доналд Тръмп	доналд тръмп	PER	xxx
Джо Байдън	джо байдън	PER	xxx
Съединените щати	съединя-(се) щат	LOC	xxx
Републиканците	републиканец	PER	xxx
Джаред Къшнер	джаред къшнер	PER	xxx
Израел	израел	LOC	xxx
Съветския съюз	съветски съюз	LOC	xxx
Джордж Буш	джордж буш	PER	xxx
Барак Обама	барак обама	PER	xxx
Америка	америка	LOC	xxx
Вашингтон Поуст	вашингтон поуст	LOC	xxx
Доналд Джей Тръмп	доналд джей тръмп	PER	xxx
Хърбърт Хувър	хърбърт хувър	PER	xxx
