46
САЩ	сащ	LOC	xxx
Тръмп	тръмп	PER	xxx
Байдън	байдън	PER	xxx
Пенсилвания	пенсилвания	LOC	xxx
Джорджия	джорджия	LOC	xxx
Джо Байдън	джо байдън	PER	xxx
Камала Харис	камала харис	PER	xxx
Аризона	аризона	LOC	xxx
Белия дом	бял дом	LOC	xxx
щата Джорджия	щат джорджия	LOC	xxx
Брад Рафенспергер	брад рафенспергер	PER	xxx
Браян Уилямс	браян уилямс	PER	xxx
МSNBC	мsnbc	PRO	xxx
CNN	cnn	ORG	xxx
Fox News	fox news	PRO	xxx
Андерсън Купър	андерсън купър	PER	xxx
Републиканската партия	републикански партия	ORG	xxx
Тотална война	тотален война	EVT	xxx
Америка	америка	LOC	xxx
Доналд Тръмп	доналд тръмп	PER	xxx
