pl-106
Agrze	Agra	LOC	GPE-Agra
Ahuthanandana	Ahuthanandan	PER	PER-Velikkakathu-Sankaran-Achuthanandan
Ameryką	Ameryka	LOC	GPE-USA
Asia Bibi	Asia Bibi	PER	PER-Asia-Bibi
Bangalore	Bangalor	LOC	GPE-Bangalor
Bobby Jindal	Bobby Jindal	PER	PER-Bobby-Jindal
Bombaju	Bombaj	LOC	GPE-Mumbai
Bożego Narodzenia	Boże Narodzenie	EVT	EVT-Christmas
Brytyjczycy	Brytyjczycy	PER	GPE-Great-Britain
Che Guevara	Chue Guevara	PER	PER-Che-Guevara
Che Guevarą	Che Guevara	PER	PER-Che-Guevara
Chrystusa	Chrystus	PER	PER-Jesus-Christ
Chrystusie	Chrystus	PER	PER-Jesus-Christ
Europejczyków	Europejczycy	PER	LOC-Europe
Europie	Europa	LOC	LOC-Europe
Fidela Castro	Fidel Castro	PER	PER-Fidel-Castro
Goa	Goa	LOC	LOC-Goa
Himalajów	Himalaje	LOC	LOC-Himalaya
Hindusom	Hindusi	PER	GPE-India
Hindusów	Hindusi	PER	GPE-India
Holendrzy	Holendrzy	PER	GPE-Holand
Holy Angels	Holy Angels	ORG	ORG-Holy-Angels
Indiach	Indie	LOC	GPE-India
Indiami,	Indie	LOC	GPE-India
Indiami	Indie	LOC	GPE-India
Indie	Indie	LOC	GPE-India
Indii	Indie	LOC	GPE-India
Japonią	Japonia	LOC	GPE-Japan
Jerozolimie	Jerozolima	LOC	GPE-Jerusalem
Jezusa	Jezus	PER	PER-Jesus-Christ
Kera-alam	Kera-alam	LOC	GPE-Kera-alam
Kerala	Kerala	LOC	GPE-Kerala
Kerali	Kerala	LOC	GPE-Kerala
Keralę	Kerala	LOC	GPE-Kerala
Koczin	Koczi	LOC	GPE-Kochi
Kollam	Kollam	LOC	GPE-Kollam
Kościół malabarski	Kościół malabarski	ORG	ORG-Malabar-Church
Lenina	Lenin	PER	PER-Lenin
Luizjany	Luizjana	LOC	GPE-Louisiana
Mahometa	Mahomet	PER	PER-Mahomet
Mombaju	Mombaj	LOC	GPE-Mumbai
Nanitalu	Nanital	LOC	GPE-Nanital
Nazarecie	Nazaret	LOC	GPE-Nazareth
New Delhi	New Delhi	LOC	GPE-New-Delhi
Newyork	Newyork	PRO	PRO-Newyork-ship
Oceanem Indyjskim	Ocean Indyjski	LOC	LOC-Indian-Ocean
Pakistanem	Pakistan	LOC	GPE-Pakistan
Pakistanie	Pakistan	LOC	GPE-Pakistan
Parlamentu Europejskiego	Parlament Europejski	ORG	ORG-European-Parliament
Polsce	Polska	LOC	GPE-Poland
Portugalczycy	Portugalczycy	PER	GPE-Portugal
Radżastanu	Radżastan	LOC	GPE-Rajasthan
Radżasthanie	Radżastan	LOC	GPE-Rajasthan
Ramkrishnana Suryabhana Gavai	Ramkrishnan Suryabhan Gavai	PER	PER-Ramkrishnan-Suryabhan-Gavai
Stalinów	Staliny	PER	PER-Stalin
Thiruvananthapuram	Thiruvananthapuram	LOC	GPE-Thiruvananthapuram
Udajpurze	Udajpur	LOC	GPE-Udaipur
Wielkanocy	Wielkanoc	EVT	EVT-Easter
Wybrzeżu Malabarskim	Wybrzeże Malabarskie	LOC	LOC-Malabar-Coast
Włoszech	Włochy	LOC	GPE-Italy
posągiem Jezusa Chrystusa	posąg Jezusa Chrystusa	LOC	LOC-Jesus-Christ-Statue
wSieci Historii	wSieci Historii	PRO	PRO-wScieci-Historii
Święta Bożego Narodzenia	Święta Bożego Narodzenia	EVT	EVT-Christmas
Święty Tomasz	Święty Tomasz	PER	PER-Saint-Thomas
św. Jerzy	Święty Jerzy	PER	PER-Saint-George
świętego Tomasza	Święty Tomasz	PER	PER-Saint-Thomas
świętego Tomasza	święty Tomasz	PER	PER-Saint-Thomas
