pl-13
Asi Bibi	Asia Bibi	PER	PER-Asia-Bibi
Asia Bibi	Asia Bibi	PER	PER-Asia-Bibi
Asię Bibi	Asia Bibi	PER	PER-Asia-Bibi
Associated Press	Associated Press	ORG	ORG-AP-The-Associated-Press
Bibi	Bibi	PER	PER-Asia-Bibi
Franciszek	Franciszek	PER	PER-Pope-Francis
Islamabadu	Islamabad	LOC	GPE-Islamabad
Khadim Hussain Rizvi	Khadim Hussain Rizvi	PER	PER-Khadim-Hussain-Rizvi
Mahometa	Mahomet	PER	PER-Mahomet
Mahometowi	Mahomet	PER	PER-Mahomet
Muhammad	Muhammad	PER	PER-Prophet-Muhammad
PAP	PAP	ORG	ORG-PAP-Polish-Press-Agency
Pakistan	Pakistan	LOC	GPE-Pakistan
Pakistanie	Pakistan	LOC	GPE-Pakistan
Pakistańczyków	Pakistańczycy	PER	GPE-Pakistan
RadioZET	RadioZET	PRO	PRO-RadioZET
SN	SN	ORG	ORG-Supreme-Court-of-Pakistan
Sąd Najwyższy	Sąd Najwyższy	ORG	ORG-Supreme-Court-of-Pakistan
TLP	TLP	ORG	ORG-Tehreek-e-Labbaik-Pakistan
Twitterze	Twitter	PRO	PRO-Twitter
