pl-200
Antonio Tajani	Antonio Tajani	PER	PER-Antonio-Tajani
Asi Bibi	Asia Bibi	PER	PER-Asia-Bibi
Boko Haram	Boko Haram	ORG	ORG-Boko-Haram
Iraku	Irak	LOC	GPE-Iraq
Koloseum	Koloseum	LOC	LOC-Colloseum-Rome
Mahometowi	Mahomet	PER	PER-Mahomet
Nigerii	Nigeria	LOC	GPE-Nigeria
ONZ	ONZ	ORG	ORG-United-Nations
Papieskie Stowarzyszenie Pomoc Kościołowi w Potrzebie	Papieskie Stowarzyszenie Pomoc Kościołowi w Potrzebie	ORG	ORG-ACN-Aid-to-the-Church-in-Need
Parlamentu Europejskiego	Parlament Europejski	ORG	ORG-European-Parliament
Parolin	Parolin	PER	PER-Pietro-Parolin
Pietro Parolin	Pietro Parolin	PER	PER-Pietro-Parolin
Rebecca Bitrus	Rebecca Bitrus	PER	PER-Rebecca-Bitrus
Stolicy Apostolskiej	Stolica Apostolska	LOC	GPE-Vatican
Syrii	Syria	LOC	GPE-Syria
Watykan	Watykan	LOC	GPE-Vatican
amfiteatrem Flawiuszów	amfiteatr Flawiuszów	LOC	LOC-Amphitheatrum-Flavium
kościół świętego Pawła w Mosulu	kościół świętego Pawła w Mosulu	LOC	LOC-Saint-Paul-cathedral-Mosul
maronicka katedra świętego Eliasza w Aleppo	maronicka katedra świętego Eliasza w Aleppo	LOC	LOC-Saint-Elijah-Cathedral-Aleppo
