sl-231
Koalicije ustavnega loka	koalicija ustaven lok	PRO	xxx
LMŠ	LMŠ	ORG	314-0
SD	SD	ORG	xxx
Levica	Levica	ORG	314-1
SAB	SAB	ORG	xxx
Jože P. Damijan	Jože P. Damijan	PER	322-19
Tomažu Gantarju	Tomaž Gantar	PER	298-12
Damijan	Damijan	PER	xxx
Digitalna NK	digitalen NK	PER	xxx
#Covid19	#covid19	PRO	xxx
KUL	kul	ORG	xxx
@StrankaLMS	@strankalms	ORG	xxx
@StrankaSAB	@strankasab	ORG	xxx
@vladaRS	Švladars	PER	xxx
Joze P. Damijan	Joze P. Damijan	PER	322-22
Slovenija	Slovenija	LOC	xxx
Keber	Keber	PER	xxx
Dušan Keber	Dušan Keber	PER	xxx
svetovne zdravstvene organizacije	svetoven zdravstven organizacija	ORG	xxx
NIJZ	Nijz	ORG	195-4
Objektivu	objektiv	PRO	78-16
