pl-22
Ashiq Masih	Ashiq Masih	PER	PER-Ashiq-Masih
Asia Bibi	Asia Bibi	PER	PER-Asia-Bibi
Asii	Asia	PER	PER-Asia-Bibi
Asię Bibi	Asia	PER	PER-Asia-Bibi
Bibi	Bibi	PER	PER-Asia-Bibi
Franciszek	Franciszek	PER	PER-Pope-Francis
Franciszem	Francisz	PER	PER-Pope-Francis
Koloseum w Rzymie	Koloseum w Rzymie	LOC	LOC-Colloseum-Rome
Koran	Koran	PRO	PRO-The-Quran
Mahometowi	Mahomet	PER	PER-Mahomet
Pakistan	Pakistan	LOC	GPE-Pakistan
Pakistanie	Pakistan	LOC	GPE-Pakistan
Pakistanu	Pakistan	LOC	GPE-Pakistan
Reuters	Reuters	ORG	ORG-Reuters
Saiful Mulook	Saiful Mulook	PER	PER-Saif-Ul-Malook
Saqib Nasir	Saqib Nasir	PER	PER-Mian-Saqib-Nisar
Sąd Najwyższy Pakistanu	Sąd Najwyższy Pakistanu	ORG	ORG-Supreme-Court-of-Pakistan
TLP	TLP	ORG	ORG-Tehreek-e-Labbaik-Pakistan
Tehreek-e-Labaik	Tehreek-e-Labaik	ORG	ORG-Tehreek-e-Labbaik-Pakistan
agencja Associated Press	agencja Associated Press	ORG	ORG-AP-The-Associated-Press
