sl-170
COVID 19	Covid 19	MISC	63-1
Dragan Kovačić	Dragan Kovačić	PER	xxx
SB Celje	SB Celje	ORG	xxx
PU Celje	PU Celje	ORG	179-2
COVID19	covid19	MISC	63-3
Celjska splošna bolnišnica	celjski splošen bolnišnica	ORG	xxx
COVID	covid	ORG	xxx
Sloveniji	Slovenija	LOC	xxx
Celju	Celje	LOC	63-0
celjski	celjski	LOC	xxx
domov za starejše občane	domov za star občan	ORG	xxx
Celjska bolnišnica	celjski bolnišnica	ORG	xxx
COVID-u	Coviden	MISC	xxx
Zato	zato	ORG	xxx
Kovačić	Kovačić	PER	xxx
COVID-a	Coviden	MISC	xxx
PGE Celje	PGE Celje	ORG	179-20
Da policija	da policija	ORG	xxx
Zdravstvenemu inšpektoratu	zdravstven inšpektorat	ORG	340-14
