sl-224
Covid-19	covid-19	MISC	66-0
sloveniji	slovenija	LOC	xxx
Sloveniji	Slovenija	LOC	xxx
Zaradi	zaradi	MISC	xxx
covida-19	covida-19	MISC	xxx
covidom-19	covidom-19	MISC	xxx
Jelko Kacin	Jelko Kacin	PER	322-33
Kacin	Kacin	PER	xxx
covidom-19 za starejše	covidom-19 za star	MISC	xxx
domovih za starejše	dom za star	ORG	xxx
osrednjeslovenske	osrednjeslovenski	LOC	78-13
savinjske	savinjski	LOC	xxx
pomurske	pomurski	LOC	181-9
jugovzhodne Slovenije	jugovzhoden Slovenija	LOC	322-12
podravske	podravski	LOC	xxx
gorenjske	gorenjski	LOC	xxx
koroške	koroški	LOC	xxx
zasavske	zasavski	LOC	xxx
obalno-kraške	obalnovkraški	LOC	xxx
goriške	goriški	LOC	xxx
posavske	posavski	LOC	xxx
Univerzitetnem kliničnem centru	univerziteten kliničen center	ORG	265-20
UKC Ljubljana	UKC Ljubljana	ORG	265-0
Twitterju	Twitter	MISC	298-0
UKC Maribor	UKC Maribor	ORG	265-0
Splošni bolnišnici Celje	splošen bolnišnica Celje	ORG	xxx
enoti intenzivne terapije	enota intenziven terapija	ORG	xxx
Kliniki Golnik	klinika Golnik	ORG	xxx
Splošni bolnišnici Slovenj Gradec	splošen bolnišnica Slovenj Gradec	ORG	xxx
covid-19	covid-19	MISC	xxx
Splošne bolnišnice Slovenj Gradec	splošen bolnišnica Slovenj Gradec	ORG	xxx
