ua-1041
Brexit	Brexit	EVT	EVT-Brexit
Sky News	Sky News	ORG	ORG-Sky-News
The Sunday Times	The Sunday Times	PRO	PRO-The-Sunday-Times
Європейського союзу	Європейський союз	ORG	ORG-European-Union
Євросоюз	Євросоюз	ORG	ORG-European-Union
Брюсселю	Брюссель	LOC	GPE-Brussles
Велика Британія	Велика Британія	LOC	GPE-Great-Britain
Велику Британію	Велика Британія	LOC	GPE-Great-Britain
Домінік Рааб	Домінік Рааб	PER	PER-Dominic-Raab
Естер Маквей	Естер Маквей	PER	PER-Ester-Makvi
КИЇВ	Київ	LOC	GPE-Kiev
Кент	Кент	LOC	GPE-Kent
Консервативної партії	Консервативна партія	ORG	ORG-Conservative-and-Unionist-Party-UK
Мей	Мей	PER	PER-Theresa-May
Міноборони	Міноборони	ORG	ORG-Ministry-of-Defence
Палаті громад	Палата громад	ORG	ORG-House-of-Commons
Тереза   Мей	Тереза Мей	PER	PER-Theresa-May
УНН	УНН	ORG	ORG-UNN
операції Temperer	Операція Temperer	EVT	EVT-Operation-Temperer
