sl-160
Cristiana Ronalda	Cristiano Ronaldo	PER	PER-Cristiano-Ronaldo
Cristiano Ronaldo	Cristiano Ronaldo	PER	PER-Cristiano-Ronaldo
Dongqiudi	Dongqiudi	PRO	PRO-Dongquidi-app
Florentinom Perezom	Florentino Perez	PER	PER-Florentino-Perez
La Ligi	La Liga	EVT	EVT-La-Liga
Leganesom	Leganes	ORG	ORG-Leganes-football-club
Lige prvakov	Liga prvakov	EVT	EVT-UEFA-Champions-League
Ligi prvakov	Liga prvakov	EVT	EVT-UEFA-Champions-League
Ligo prvakov	Liga prvakov	EVT	EVT-UEFA-Champions-League
Madridu	Madrid	LOC	GPE-Madrid
Madridu	Madrid	ORG	ORG-Real-Madrid
Manchester Uniteda	Manchester United	ORG	ORG-Manchester-United-FC
Paris Saint-Germaina	Paris Saint-Germain	ORG	ORG-Paris-Saint-Germain
Portugalec	Portugalec	PER	GPE-Portugal
Portugalski	Portugalska	LOC	GPE-Portugal
Reala	Real	ORG	ORG-Real-Madrid
Realu	Real	ORG	ORG-Real-Madrid
Ronaldo	Ronaldo	PER	PER-Cristiano-Ronaldo
Valdebebas	Valdebebas	LOC	LOC-Valdebebas
Valencio	Valencia	ORG	ORG-Valencia-Football-Club
državni naslov	državni naslov	EVT	EVT-La-Liga
evropski superpokal	evropski superpokal	EVT	EVT-UEFA-Super-Cup
klubsko svetovno prvenstvo	klubsko svetovno prvenstvo	EVT	EVT-FIFA-Club-World-Cup
madridskega Reala	madridski Real	ORG	ORG-Real-Madrid
Španija	Španija	LOC	GPE-Spain
Španije	Španija	LOC	GPE-Spain
Španijo	Španija	LOC	GPE-Spain
španski superpokal	španski superpokal	EVT	EVT-Spanish-Supercup
