sl-104
Ambra	Ambra	ORG	ORG-Ambra
Ankara	Ankara	LOC	GPE-Ankara
Ankaro	Ankara	LOC	GPE-Ankara
Dnevnik	Dnevnik	PRO	
Društvo Medkulturni dialog	Društvo Medkulturni dialog	ORG	ORG-Društvo-Medkulturni-Dialog
Ekrem Dumanli	Ekrem Dumanli	PER	PER-Ekrem-Dumanli
Erdogana	Erdogan	PER	PER-Recep-Tayyip-Erdoğan
Erdoganovega	Erdogan	PER	PER-Recep-Tayyip-Erdoğan
Erdoganovimi	Erdogan	PER	PER-Recep-Tayyip-Erdoğan
Evropi	Evropa	LOC	GPE-Europe
Fethullaha Gülena	Fethullah Gülen	PER	PER-Fethullah-Gülen
Gülenovim gibanjem	Gülenovo gibanje	ORG	ORG-Güllen-Movement
KOM	KOM	ORG	ORG-Anti-Smuggling-and-Organized-Crime-Department
Kaynak Holdingu	Kaynak Holding	ORG	ORG-Kaynak-Corporation
Kaynak	Kaynak	ORG	ORG-Kaynak-Corporation
Kaynaka	Kaynak	ORG	ORG-Kaynak-Corporation
Ljubljani	Ljubljana	LOC	GPE-Ljubljana
Nordic Monitor	Nordic Monitor	ORG	ORG-Nordic-Monitor
Nordic Monitorja	Nordic Monitor	ORG	ORG-Nordic-Monitor
Recepa Tayyipa Erdogana	Recep Tayyip Erdogan	PER	PER-Recep-Tayyip-Erdoğan
Serra Kaleli	Serra Kaleli	PER	PER-Serra-Kaleli
Sloveniji	Slovenija	LOC	GPE-Slovenia
Stockholma	Stockholm	LOC	GPE-Stockholm
Turčije	Turčija	LOC	GPE-Turkey
Turčiji	Turčija	LOC	GPE-Turkey
Turčijo	Turčija	LOC	GPE-Turkey
Turški diplomati	Turški diplomati	PER	ORG-Turkish-Embassy
Zaman	Zaman	PRO	PRO-Zaman
oddelka turške policije za boj proti tihotapstvu in organiziranemu kriminalu	oddelek turške policije za boj proti tihotapstvu in organiziranemu kriminalu	ORG	ORG-Anti-Smuggling-and-Organized-Crime-Department
Švice	Švica	LOC	GPE-Switzerland
