sl-86
Airbnb	Airbnb	ORG	ORG-Airbnb
Baltimora	Baltimore	LOC	GPE-Baltimore
Barrai Omuireagain	Barrai Omuireagain	PER	PER-Barrai-Omuireagain
Bostona	Boston	LOC	GPE-Boston
Denise Riordan	Denise Riordan	PER	PER-Denise-Riordan
Dublin	Dublin	LOC	GPE-Dublin
EasyJet	EasyJet	ORG	ORG-EasyJet
Evrope	Evropa	LOC	GPE-Europe
Evropo	Evropa	LOC	GPE-Europe
Icelandair	Icelandair	ORG	ORG-Icelandair
Indiane	Indiana	LOC	GPE-Indiana
Indigo Partners	Indigo Partners	ORG	ORG-Indigo-Partners
Irka	Irka	PER	GPE-Ireland
Irskem	Irska	LOC	GPE-Ireland
Islandije	Islandija	LOC	GPE-Iceland
Newarka	Newark	LOC	GPE-Newark
Norwegian air	Norwegian air	ORG	ORG-Norwegian
Ollieja	Ollie	PER	PER-Ollie
Pariz	Pariz	LOC	GPE-Paris
RUV	RUV	ORG	ORG-RUV
Reykjavik	Reykjavik	LOC	GPE-Reykjavik
Reykjavika	Reykjavik	LOC	GPE-Reykjavik
Reykjaviku	Reykjavik	LOC	GPE-Reykjavik
Severne Amerike	Severna Amerika	LOC	LOC-North-America
Severno Ameriko	Severna Amerika	LOC	LOC-North-America
Skúli Mogensen	Skúli Mogensen	PER	PER-Skúli-Mogensen
Suher Adi	Suher Adi	PER	PER-Suher-Adi
Washingtona	Washington	LOC	GPE-WashingtonDC
Wizz air	Wizz air	ORG	ORG-Wizz-Air
Wizz airu	Wizz air	ORG	ORG-Wizz-Air
Wow air	Wow air	ORG	ORG-Wow-air
Wow aira	Wow air	ORG	ORG-Wow-air
XL Airways	XL Airways	ORG	ORG-XL-Airways
islandski urad za promet	islandski urad za promet	ORG	ORG-Icelandic-Transport-Authority
