sl-128
Pošte Slovenije	pošta Slovenija	ORG	177-2
Še	še	LOC	xxx
Pošta Slovenije	pošta Slovenija	LOC	177-41
COVIDA-19	covida-19	PRO	xxx
Tudi	tudi	LOC	xxx
NIJZ	Nijz	ORG	191-0
Nacionalnega inštituta za javno zdravje Ljubljana	nacionalen inštitut za javen zdravje Ljubljana	ORG	191-1
Univerzitetnem kliničnem centru Ljubljana Maribor	univerziteten kliničen center Ljubljana Maribor	LOC	264-1
Univerzitetnem kliničnem centru Maribor Rakičan	univerziteten kliničen center Maribor Rakičan	LOC	264-1
Splošne bolnišnice Murska Sobota Solčava Luče Kuzma	splošen bolnišnica murski Sobota Solčava Luče Kuzma	ORG	xxx
Domu upokojencev Puconci	dom upokojenec Puconci	ORG	xxx
PS Paketomatov	PS paketomat	PRO	xxx
PS 24/7	Ps 24/7	PRO	178-11
Ljubljani	Ljubljana	LOC	312-0
Kopru	Koper	LOC	xxx
Direct4.me	direct4.me	PRO	xxx
Sloveniji	Slovenija	LOC	xxx
Društvo spletnih trgovcev	društvo spleten trgovec	ORG	xxx
Slovenije	Slovenija	LOC	xxx
poštni logistični center Maribor	pošten logističen center Maribor	LOC	178-8
poštni logistični center Ljubljana	pošten logističen center Ljubljana	LOC	178-16
Mariboru	Maribor	LOC	252-15
