pl-31
Asia Bibi	Asia Bibi	PER	PER-Asia-Bibi
Asii Bibi	Asia Bibi	PER	PER-Asia-Bibi
Berlinie	Berlin	LOC	GPE-Berlin
Bibi	Bibi	PER	PER-Asia-Bibi
Bild am Sonntag	Bild am Sonntag	PRO	PRO-Bild-am-Sonntag
Katrin Goering-Eckardt	Katrin Goering-Eckardt	PER	PER-Katrin-Goering-Eckardt
Mohameda	Mohame	PER	PER-Mahomet
Niemcy	Niemcy	LOC	GPE-Germany
Niemiec	Niemcy	LOC	GPE-Germany
Niemiecki rząd	Niemiecki rząd	ORG	ORG-German-Government
Pakistanie	Pakistan	LOC	GPE-Pakistan
Pakistanu	Pakistan	LOC	GPE-Pakistan
RFN	RFN	LOC	GPE-Germany
Saif-ul-Malook	Saif-ul-Malook	PER	PER-Saif-Ul-Malook
Sąd Najwyższy	Sąd Najwyższy	ORG	ORG-Supreme-Court-of-Pakistan
Sądu Najwyższego	Sąd Najwyższy	ORG	ORG-Supreme-Court-of-Pakistan
Zielonych	Zieloni	ORG	ORG-Green-Party-Germany
klubu poselskiego Zielonych w Bundestagu	klub poselski Zielonych w Bundestagu	ORG	ORG-Green-Party-faction-Bundestag
niemiecki MSZ	niemiecki MSZ	ORG	ORG-Ministry-of-Foreign-Affairs-Germany
niemiecki rząd	niemiecki rząd	ORG	ORG-German-Government
niemieckiego MSZ	niemiecki MSZ	ORG	ORG-Ministry-of-Foreign-Affairs-Germany
