pl-166
Alego	Ali	PER	PER-Ali-Prophet
Ali	Ali	PER	PER-Ali-Prophet
Allaha	Allah	PER	PER-Allah
Asi Bibi	Asia Bibi	PER	PER-Asia-Bibi
Bahawalpur	Bahawalpur	LOC	GPE-Bahawalpur
Facebooku	Facebook	PRO	PRO-Facebook
Fatimy	Fatima	PER	PER-Fatima-Prophet
Mahometa	Mahomet	PER	PER-Mahomet
Mardan	Mardan	LOC	GPE-Mardan
Nawaz Sharif	Nawaz Sharif	PER	PER-Nawaz-Sharif
Pakistan	Pakistan	LOC	GPE-Pakistan
Pakistanie	Pakistan	LOC	GPE-Pakistan
Pendżabu	Pendżab	LOC	GPE-Punjab
Razę	Raza	PER	PER-Taimoor-Raza
Salman Taseer	Salman Taseer	PER	PER-Salmaan-Taseer
Shabbaz Batti	Shabbaz Batti	PER	PER-Clement-Shahbaz-Bhatti
Shabir Ahmed	Shabir Ahmed	PER	PER-Shabir-Ahmed
Shafiq Chaudhry	Shafiq Chaudhry	PER	PER-Shafiq-Chaudhry
Taimore Razy	Taimore Raza	PER	PER-Taimoor-Raza
Taseer	Taseer	PER	PER-Salmaan-Taseer
Taseera	Taseer	PER	PER-Salmaan-Taseer
