uk-45
Die Welt	Die Welt	ORG	ORG-Die-Welt
Nord Stream-2	Nord Stream-2	ORG	ORG-Nord-Stream-2-AG
Nord Stream	Nord Stream	ORG	ORG-Nord-Stream-AG
ЄС	ЄС	LOC	ORG-European-Union
Єврокомісії	Єврокомісія	ORG	ORG-European-Commission
Європи	Європа	LOC	GPE-Europe
Балтійським морем	Балтійське море	LOC	LOC-Baltic-Sea
Данії	Данія	LOC	GPE-Denmark
Естонії	Естонія	LOC	GPE-Estonia
Москві	Москва	LOC	GPE-Moscow
Міксер	Міксер	PER	PER-Sven-Mikser
Німеччину	Німеччина	LOC	GPE-Germany
Північного потоку-2	Північний потік-2	ORG	ORG-Nord-Stream-2-AG
Росію	Росія	LOC	GPE-Russia
Росія	Росія	LOC	GPE-Russia
Росії	Росія	LOC	GPE-Russia
США	США	LOC	GPE-USA
Свен Міксер	Свен Міксер	PER	PER-Sven-Mikser
України	Україна	LOC	GPE-Ukraine
