sl-0
Asia Bibi	Asia Bibi	PER	PER-Asia-Bibi
Asia Noreen	Asia Noreen	PER	PER-Asia-Bibi
Asia	Asia	PER	PER-Asia-Bibi
Asio Bibi	Asia Bibi	PER	PER-Asia-Bibi
BBC	BBC	PRO	PRO-BBC
BIbijeva	Bibi	PER	PER-Asia-Bibi
Bibijeva	Bibi	PER	PER-Asia-Bibi
Bibijevi	Bibi	PER	PER-Asia-Bibi
Bibijevo	Bibi	PER	PER-Asia-Bibi
Bibijino	BIbi	PER	PER-Asia-Bibi
Kanadi	Kanada	LOC	GPE-Canada
Kanado	Kanada	LOC	GPE-Canada
Lahoreja	Lahore	LOC	GPE-Lahore
Maulana Yousaf Qureshi	Maulana Yousaf Qureshi	PER	PER-Maulana-Yousaf-Qureshi
Mohamedu	Mohamed	PER	PER-Prophet-Muhammad
Pakistan	Pakistan	LOC	GPE-Pakistan
Pakistana	Pakistan	LOC	GPE-Pakistan
Pakistanu	Pakistan	LOC	GPE-Pakistan
Punjab	Punjab	LOC	GPE-Punjab
Saiful Muluk	Saiful Muluk	PER	PER-Saiful-Mulook
Salmaan Taseer . Bhatti	Salmaan Taseer Bhatti	PER	PER-Salmaan-Taseer
Shahbaz Bhatti	Shahbaz Bhatti	PER	PER-Clement-Shahbaz-Bhatti
The Guardian	The Guardian	PRO	PRO-The-Guardian
pakistanki	pakistanka	PER	GPE-Pakistan
papež Benedikt XVI	papež Benedikt XVI	PER	PER-Benedict-XVI
papež Frančišek	papež Frančišek	PER	PER-Pope-Francis
