ru-126
The Guardian	The Guardian	PRO	PRO-The-Guardian
Асии Биби	Асия Биби	PER	PER-Asia-Bibi
Асию Биби	Асия Биби	PER	PER-Asia-Bibi
Асия Биби	Асия Биби	PER	PER-Asia-Bibi
Биби	Биби	PER	PER-Asia-Bibi
Верховного суда	Верховный суд	ORG	ORG-Supreme-Court-of-Pakistan
Верховный суд	Верховный суд	ORG	ORG-Supreme-Court-of-Pakistan
Джамаат уд-Дава	Джамаат уд-Дава	ORG	ORG-Jamaat-ud-Dawa
Джамаат улема-е-ислам	Джамаат улема-е-ислам	ORG	ORG-Jamiat-Ulema-e-Islam
Имрана Хана	Имран Хан	PER	PER-Imran-Khan
Исламабада	Исламабад	LOC	GPE-Islamabad
Кирилл	Кирилл	PER	PER-Kirill-The-Patriarch-of-Moscow-and-all-Ru
Китае	Китай	LOC	GPE-China
Корану	Коран	PRO	PRO-The-Quran
Мумтаз Кадри	Мумтаз Кадри	PER	PER-Mumtaz-Qadri
Мухаммада	Мухаммад	PER	PER-Prophet-Muhammad
ООН	ООН	ORG	ORG-United-Nations
Пакистана	Пакистан	LOC	GPE-Pakistan
Пакистане	Пакистан	LOC	GPE-Pakistan
Папа Римский	Папа Римский	PER	PER-Benedict-XVI
Пенджаба	Пенджаб	LOC	GPE-Punjab
Ризви	Ризви	PER	PER-Khadim-Hussain-Rizvi
Русской православной церкви	Русская православная церковь	ORG	ORG-Russian-Orthodox-Church
Салман Тасир	Салман Тасир	PER	PER-Salmaan-Taseer
Техрик-э-Лабаик	Техрик-э-Лабаик	ORG	ORG-Tehreek-e-Labbaik-Pakistan
Хадимом Хусейном Ризви	Хадим Хусейн Ризви	PER	PER-Khadim-Hussain-Rizvi
Хафизом Саидом	Хафиз Саид	PER	PER-Hafiz-Muhammad-Saeed
