pl-215
Afganistanem	Afganistan	LOC	GPE-Afghanistan
Arif-ur-Rehmana Alviego	Arif-ur-Rehman Alvi	PER	PER-Arif-ur-Rehman-Alvi
Dżamiat Ulema-e-Islam-Samiul	Dżamiat Ulema-e-Islam-Samiul	ORG	ORG-Jamiat-Ulema-e-Islam
Imrana Khana	Imran Khan	PER	PER-Imran-Khan
JUI-S	JUI-S	ORG	ORG-Jamiat-Ulema-e-Islam
Maulana Hami-ul-Hak	Maulana Hami-ul-Hak	PER	PER-Maulan-Hami-ul-Haq
Maulana Sami-ul-Hak	Maulana Sami-ul-Hak	PER	PER-Maulan-Sami-ul-Haq
Maulanę Sami ul-Haqa	Maulana Sami ul-Hak	PER	PER-Maulan-Sami-ul-Haq
Muhammad Bilal	Muhammad Bilal	PER	PER-Muhammad-Bilal
Omarem	Omar	PER	PER-Mullah-Omar
PTI	PTI	ORG	ORG-Tehreek-e-Insaf
Pakistan Tehreek-e-Insaf	Pakistan Tehreek-e-Insaf	ORG	ORG-Tehreek-e-Insaf
Pakistanie	Pakistan	LOC	GPE-Pakistan
Pakistanu	Pakistan	LOC	GPE-Pakistan
Rawalpindi	Rawalpindi	LOC	GPE-Rawalpindi
Reutera	Reuter	ORG	ORG-Reuters
pakistańskiego Senatu	pakistański Senat	ORG	ORG-Senate-Pakistan
protest w Islamabadzie przeciwko uniewinnieniu chrześcijanki Asi Bibi,	protest w Islamabadzie przeciwko uniewinnieniu chrześcijanki Asi Bibi,	EVT	EVT-protest-Islamabad-against-freeing-Asia-Bibi
ruchu Talibów	ruch Talibów	ORG	ORG-Taliban
talibów	Talibowie	ORG	ORG-Taliban
