sl-68
Aerodrom Maribor	Aerodrom Maribor	LOC	ORG-Maribor-Edvard-Rusjan-Airport
Aerodroma Maribor	Aerodrom Maribor	LOC	ORG-Maribor-Edvard-Rusjan-Airport
Angleži	Angleži	PER	GPE-England
Antwerpen	Antwerpen	LOC	GPE-Antwerp
Avstrijci	Avstrijci	PER	GPE-Austria
Bergamo	Bergamo	LOC	GPE-Bergamo
Bledu	Bled	LOC	GPE-Bled
Celje	Celje	LOC	GPE-Celje
DPN	DPN	PRO	PRO-DPN-Državni-prostorski-načrt
Dobrna	Dobrna	LOC	GPE-Dobrna
Düsseldorf	Düsseldorf	LOC	GPE-Dusseldorf
Evropejcev	Evropejci	PER	LOC-Europe
Filip Tobias	Filip Tobias	PER	PER-Filip-Tobias
GIZ Rast	GIZ Rast	ORG	ORG-regionalna-aviodestinacija-slovenskega-turizma-gospodarsko-interesno-združenje
Hrvatom	Hrvati	PER	GPE-Croatia
Hrvaška	Hrvaška	LOC	GPE-Croatia
Hrvaško	Hrvaška	LOC	GPE-Croatia
Italijani	Italijani	PER	GPE-Italy
Jadranskega morja	Jadransko morje	LOC	LOC-Adriatic-sea
Jadranski obali	Jadranska obala	LOC	LOC-Adriatic-Coast
Karitasu	Karitas	ORG	ORG-Caritas
Kitajcev	Kitajci	PER	GPE-China
Kitajci	Kitajci	PER	GPE-China
LCM	LCM	LOC	LOC-LCM-Letalski-center-Maribor
Lentu	Lent	EVT	EVT-Lent-Festival
Letalskega centra Maribor	Letalski center Maribor	LOC	LOC-LCM-Letalski-center-Maribor
Letalskemu centru Maribor	Letalski center Maribor	LOC	LOC-LCM-Letalski-center-Maribor
Ljubljana	Ljubljana	LOC	GPE-Ljubljana
Ljubljani	Ljubljana	LOC	GPE-Ljubljana
Ljubljano	Ljubljana	LOC	GPE-Ljubljana
Majorki	Majorka	LOC	GPE-Mallorca
Maribor	Maribor	LOC	GPE-Maribor
Maribora	Maribor	LOC	GPE-Maribor
Mariboru	Maribor	LOC	GPE-Maribor
Milano	Milano	LOC	GPE-Milan
München	München	LOC	GPE-Munich
Nemci	Nemci	PER	GPE-Germany
Nordkap	Nordkap	LOC	GPE-NordKapp
Olimje	Olimje	LOC	GPE-Olimije
Osnovne šole Franceta Prešerna	Osnovna šola Franceta Prešerna	ORG	ORG-Osnovna-šola-Franceta-Prešerna
Pelješcu	Pelješac	LOC	GPE-Pelješac
Prago	Praga	LOC	GPE-Prague
Prekmurje	Prekmurje	LOC	GPE-Prekmurje
Prešerna	Prešeren	PER	PER-France-Prešeren
Ptuj	Ptuj	LOC	GPE-Ptuj
Rogaška Slavina	Rogaška Slatina	LOC	GPE-Rogaška-Slatina
Rolling Stones	Rolling Stones	ORG	ORG-The-Rolling-Stones
Rusija	Rusija	LOC	GPE-Russia
Ryanair	Ryanair	ORG	ORG-Ryanair
Slovenija	Slovenija	LOC	GPE-Slovenia
Slovenije	Slovenija	LOC	GPE-Slovenia
Sloveniji	Slovenija	LOC	GPE-Slovenia
Slovenijo	Slovenija	LOC	GPE-Slovenia
Slovenska turistična organizacija	Slovenska turistična organizacija	ORG	ORG-Slovenian-Tourist-Board
Tobias	Tobias	PER	PER-Filip-Tobias
Topolšica	Topolšica	LOC	GPE-Topolšica
Toševo	Toše	PER	PER-Toše-Proeski
Turistično gostinske zbornice Slovenije	Turistično gostinska zbornica Slovenije	ORG	ORG-Turistično-gostinska-zbornica-Slovenije
Zadar	Zadar	LOC	GPE-Zadar
Zadrom	Zadar	LOC	GPE-Zadar
Združenja turističnih agencij Slovenije	Združenje turističnih agencij Slovenije	ORG	ORG-ZTAS-Združenje-turističnih-agencij-Slovenije
agencije Sonček	agencija Sonček	ORG	ORG-Sonchek-Tourist-Agency
državni prostorski načrt	državni prostorski načrt	PRO	PRO-DPN-Državni-prostorski-načrt
severne Italije	severni Italija	LOC	GPE-Northern-Italy
