pl-90
Asii Bibi	Asia Bibi	PER	PER-Asia-Bibi
Azji	Azja	LOC	LOC-Asia
Benedykt XVI	Benedykt XVI	PER	PER-Benedict-XVI
Bibi	Bibi	PER	PER-Asia-Bibi
Bliskim Wschodzie	Bliski Wschód	LOC	LOC-Near-East
Borisa Johnsona	Boris Johnson	PER	PER-Boris-Johnson
Ejaz Ashrafi	Ejaz Ashrafi	PER	PER-Ejaz-Ashrafi
Franciszek	Franciszek	PER	PER-Pope-Francis
Holandia	Holandia	LOC	GPE-Holland
Islamabadzie	Islamabad	LOC	GPE-Islamabad
Justin Trudeau	Justin Trudeau	PER	PER-Justin-Trudeau
Kanada	Kanada	LOC	GPE-Canada
Kanadyjczycy	Kanadyjczycy	PER	GPE-Canada
Kanadyjczyka	Kanadyjczyk	PER	GPE-Canada
Londyn	Londyn	LOC	GPE-London
Niemcy	Niemcy	LOC	GPE-Germany
Ottawie	Ottawa	LOC	GPE-Ottawa
Pakistan	Pakistan	LOC	GPE-Pakistan
Pakistanka	Pakistanka	PER	GPE-Pakistan
Parlamentu Europejskiego	Parlament Europejski	ORG	ORG-European-Parlament
Paryżu	Paryż	LOC	GPE-Paris
Pendżab	Pendżab	LOC	GPE-Punjab
Stany Zjednoczone	Stany Zjednoczone	LOC	GPE-USA
Sądu Najwyższego	Sąd Najwyższy	ORG	ORG-Supreme-Court-of-Pakistan
Tehrik-e-Labaik	Tehrik-e-Labaik	ORG	ORG-Tehreek-e-Labbaik-Pakistan
The Guardian	The Guardian	PRO	PRO-The-Guardian
Trudeau	Trudeau	PER	PER-Justin-Trudeau
Wyspach	Wyspy	LOC	GPE-Great-Britain
Zjednoczonego Królestwa	Zjednoczone Królestwo	PER	GPE-Great-Britain
ministerstwo spraw zagranicznych	Ministerstwo Spraw Zagranicznych	ORG	ORG-Ministry-of-Foreign-Affairs-Poland
więzieniu Multan	więzienie Multan	LOC	LOC-Multan-prison
