pl-20
Ashiq Masih	Ashiq Masih	PER	PER-Ashiq-Masih
Asia Bibi	Asia Bibi	PER	PER-Asia-Bibi
Asia Noreen	Asia Noreen	PER	PER-Asia-Bibi
Asii Bibi	Asia Bibi	PER	PER-Asia-Bibi
BBC	BBC	PRO	PRO-BBC-TV
Bibi	Bibi	PER	PER-Asia-Bibi
Deutsche Welle	Deutsche Welle	PRO	PRO-Deutsche-Welle
Fawad Chaudry	Fawad Chaudry	PER	PER-Fawad-Chaudhry
Kanady	Kanada	LOC	GPE-Canada
Mahomecie	Mahomet	PER	PER-Mahomet
Mahometa	Mahomet	PER	PER-Mahomet
Mahometowi	Mahomet	PER	PER-Mahomet
Masih	Masih	PER	PER-Ashiq-Masih
Ojciec Święty	Ojciec Święty	PER	PER-Pope-Francis
Pakistanie	Pakistan	LOC	GPE-Pakistan
Pakistanu	Pakistan	LOC	GPE-Pakistan
Sąd Najwyższy	Sąd Najwyższy	ORG	ORG-Supreme-Court-of-Pakistan
Sądu Najwyższego	Sąd Najwyższy	ORG	ORG-Supreme-Court-of-Pakistan
TLP	TLP	ORG	ORG-Tehreek-e-Labbaik-Pakistan
USA	USA	LOC	GPE-USA
Wielkej Brytanii	Wielka Brytania	LOC	GPE-Great-Britain
Zjednoczonego Królestwa	Zjednoczone Królestwo	LOC	GPE-Great-Britain
