bg-3051
 Малок	Мулук	PER	PER-Saif-Ul-Malook
Аса	Асия	PER	PER-Asia-Bibi
Асиф Кхоса	Асиф Кхоса	PER	PER-Asif-Saeed-Khan-Khosa
Асия Биби	Асия Биби	PER	PER-Asia-Bibi
Асма	Асма	PER	PER-Asma-Jehangir
Ася Биби	Асия Биби	PER	PER-Asia-Bibi
Ася	Асия	PER	PER-Asia-Bibi
Брита Милованцева	Брита Милованцева	PER	PER-Britta-Milovanceva
Врата на Надеждата	Врата на Надеждата	ORG	ORG-Door-of-Hope-International
Върховният съд на Пакистан	Върховен съд на Пакистан	ORG	ORG-Supreme-Court-of-Pakistan
Главният съд в Лахор	Главен съд в Лахор	ORG	ORG-Lahore-High-Court
Исламабад	Исламабад	LOC	GPE-Islamabad
Исма	Исма	PER	PER-Isma
Катанвала	Катанвала	LOC	LOC-Katanwala
Корана	Коран	PRO	PRO-The-Quran
Кхоса	Кхоса	PER	PER-Asif-Saeed-Khan-Khosa
Лахор	Лахор	LOC	GPE-Lahore
Мазхар Хан	Мазхар Хан	PER	PER-Mazhar -Alam-Khan
Малок	Мулук	PER	PER-Saif-Ul-Malook
Миан Нисар	Миан Нисар	PER	PER-Mian-Saqib-Nisar
Мохамед	Мохамед	PER	PER-Prophet-Muhammad
Пакистан	Асия Биби	LOC	GPE-Pakistan
Пакистан	Пакистан	LOC	GPE-Pakistan
Сайфул Малок	Сайфул Мулук	PER	PER-Saif-Ul-Malook
Сакиб Нисар	Сакиб Нисар	PER	PER-Mian-Saqib-Nisar
Файсалабад	Файсалабад	LOC	GPE-Faisalabad
Шейхупура	Шейхупура	LOC	GPE-Shekhupura
