24
Холивуд	холивуд	LOC	xxx
Covid-19	covid-19	PRO	xxx
Калифорния	калифорния	LOC	xxx
CNBC	cnbc	PRO	xxx
Южна Калифорния	южен калифорния	LOC	xxx
Габриел Картерис	габриел картерис	PER	xxx
SAG-AFTRA	sag-aftra	ORG	xxx
Комисията за съвместни политики и	комисия за съвместен политика и	ORG	xxx
Гилдията на продуцентите в Америка	гилдия на продуцент в америка	ORG	xxx
Лос Анджелис	лос анджелис	LOC	xxx
Ерик Гарсети	ерик гарсети	PER	xxx
CBS	cbs	ORG	xxx
Warner Bros .	warner bros .	ORG	xxx
Mom	mom	PRO	xxx
B Positive	b positive	PRO	xxx
Bob Hearts Abishola	bр hearts abishola	PRO	xxx
Shameless	shameless	PRO	xxx
You	you	PRO	xxx
Netflix	netflix	ORG	xxx
Variety	variety	PRO	xxx
Universal	universal	PER	xxx
Mr	mr	PRO	xxx
.	.	PRO	xxx
Good Girls	good girls	ORG	xxx
Brooklyn Nine-Nine	brooklyn nine-nine	ORG	xxx
Walt Disney	walt disney	ORG	xxx
ABC	abc	ORG	xxx
