32
Националния оперативен щаб	национален оперативен щаб	ORG	xxx
Министерството на здравеопазването	министерство на здравеопазване	ORG	xxx
София	софия	LOC	xxx
Кюстендил	кюстендил	LOC	xxx
Смолян	смолян	LOC	xxx
COVID-19	covid-19	PRO	xxx
Благоевград	благоевград	LOC	xxx
Бургас	бургас	LOC	xxx
Варна	варна	LOC	xxx
Велико Търново	велик търново	LOC	xxx
Видин	видин	LOC	xxx
Враца	враца	LOC	xxx
Габрово	габрово	LOC	xxx
Добрич	добрич	LOC	xxx
Кърджали	кърджали	LOC	xxx
Ловеч	ловеч	LOC	xxx
Монтана	монтана	LOC	xxx
Пазарджик	пазарджик	LOC	xxx
Перник	перник	LOC	xxx
Плевен	плевен	LOC	xxx
Пловдив	пловдив	LOC	xxx
Русе	русе	LOC	xxx
МБАЛ	мбал	ORG	xxx
Шумен	шумен	PER	xxx
