37
Швеция	швеция	LOC	xxx
Европа	европа	LOC	xxx
Financial Times	financial times	PRO	xxx
Южна Корея	южен корея	LOC	xxx
Тайван	тайван	LOC	xxx
Австралия	австралия	LOC	xxx
Нова Зеландия	нов зеландия	LOC	xxx
южноевропейците	южноевропейц	PER	xxx
Дания	дания	LOC	xxx
Норвегия	норвегия	LOC	xxx
Финландия	финландия	LOC	xxx
Великобритания	великобритания	LOC	xxx
Франция	франция	LOC	xxx
Италия	италия	LOC	xxx
Белгия	белгия	LOC	xxx
Испания	испания	LOC	xxx
Европейската комисия	европейски комисия	ORG	xxx
Volvo Cars	volvo cars	ORG	xxx
Volvo Trucks	volvo trucks	ORG	xxx
Андерс Тегнел	андерс тегнел	PER	xxx
Стокхолм	стокхолм	LOC	xxx
ЕС	ес	ORG	xxx
