48
Европа	европа	LOC	xxx
Източна Азия	източен азия	LOC	xxx
The Wallstreet Journal	the wallstreet journal	PRO	xxx
Деня на благодарността	ден на благодарност	EVT	xxx
Covid-19	covid-19	PRO	xxx
Каталуния	каталуния	LOC	xxx
Арагон	арагон	LOC	xxx
Швейцария	швейцария	LOC	xxx
Испания	испания	LOC	xxx
Комас A	комас да	PER	xxx
EU1	eu1	PRO	xxx
Обединеното кралство	обединя-(се) кралство	LOC	xxx
Ирландия	ирландия	LOC	xxx
Холандия	холандия	LOC	xxx
Франция	франция	LOC	xxx
Италия	италия	LOC	xxx
Комас	комас	PER	xxx
Ухан	ухан	LOC	xxx
Южна Корея	южен корея	LOC	xxx
Япония	япония	LOC	xxx
Сингапур	сингапур	LOC	xxx
Запада	запад	LOC	xxx
Нова Зеландия	нов зеландия	LOC	xxx
Австралия	австралия	LOC	xxx
Норвегия	норвегия	LOC	xxx
Финландия	финландия	LOC	xxx
Европейският съюз	европейски съюз	ORG	xxx
ЕС	ес	ORG	xxx
Хърватия	хърватия	LOC	xxx
Гърция	гърция	LOC	xxx
