57
Коронавирус	коронавирус	ORG	xxx
Германия	германия	LOC	xxx
ЕС	ес	ORG	xxx
Белгия	белгия	LOC	xxx
Франция	франция	LOC	xxx
Гърция	гърция	LOC	xxx
Финландия	финландия	LOC	xxx
Ирландия Джонс Хопкинс	ирландия джонс хопкинс	LOC	xxx
Коледа	коледа	EVT	xxx
Франк Ванденбрук	франк ванденбрук	PER	xxx
Белгийците	белгиец	PER	xxx
Александър де Кроо	александър де кроо	PER	xxx
французите	французин	PER	xxx
Атина	атина	LOC	xxx
Солун	солун	LOC	xxx
СМС	смс	ORG	xxx
Нова година	нов година	EVT	xxx
Хелзинки	хелзинки	LOC	xxx
Еспоо	еспоо	LOC	xxx
Вантаа	вантаа	LOC	xxx
Ирландия	ирландия	LOC	xxx
