74
ЕС	ес	ORG	xxx
коронавирус	коронавирус	PRO	xxx
ЕК	ек	ORG	xxx
Европейската комисия	европейски комисия	ORG	xxx
Европейската агенция по лекарствата	европейски агенция по лекарство	ORG	xxx
БТА	бта	ORG	xxx
Урсула фон дер Лайен	урсула фон дер лайен	PER	xxx
Европа	европа	LOC	xxx
“	“	LOC	xxx
Novavax	novavax	ORG	xxx
Ангела Меркел	ангела меркел	PER	xxx
Меркел	меркел	PER	xxx
BioNTech	biontech	ORG	xxx
Pfizer	pfizer	ORG	xxx
Угур Шахин	угур шахин	PER	xxx
Йозлем Тюреджи	йозлем тюреджи	PER	xxx
Германия	германия	LOC	xxx
Bloomberg	bloomberg	ORG	xxx
Великобритания	великобритания	LOC	xxx
САЩ	сащ	LOC	xxx
