86
БАН	бан	ORG	xxx
COVID-19	covid-19	PRO	xxx
СЗО	сзо	ORG	xxx
Pfizer	pfizer	ORG	xxx
BioNTech	biontech	ORG	xxx
Moderna	moderna	ORG	xxx
Astra Zeneka	astra zeneka	ORG	xxx
Janssen-Cilag	janssen-cilag	ORG	xxx
Спутник	спутник	ORG	xxx
Vector	vector	ORG	xxx
Европейския съюз	европейски съюз	ORG	xxx
ЕС	ес	ORG	xxx
Европейската медицинска агенция	европейски медицински агенция	ORG	xxx
ЕМА	ема	ORG	xxx
Pfizer /	pfizer /	ORG	xxx
BioNtech	biontech	ORG	xxx
Astra Zeneka Janssen-Cilag	astra zeneka janssen-cilag	ORG	xxx
Sanofi-GSK	sanofi-gsk	ORG	xxx
Великобритания	великобритания	LOC	xxx
Спутник V	спутник v	PRO	xxx
Руската федерация	руски федерация	LOC	xxx
Китай	китай	LOC	xxx
Русия	русия	LOC	xxx
САЩ	сащ	LOC	xxx
FDA	fda	ORG	xxx
България	българия	LOC	xxx
Министерство на здравеопазването	министерство на здравеопазване	ORG	xxx
