uk-47
"Інтерфакс-Україна"	Інтерфакс-Україна	ORG	ORG-Interfax-Ukraine
"Економічну правду"	Економічна правда	PRO	PRO-Economic-Truth
Nord Stream 2	Nord Stream 2	ORG	ORG-Nord-Stream-2-AG
OMV	OMV	ORG	ORG-OMV
Welt am Sonntag	Welt am Sonntag	ORG	ORG-Welt-am-Sonntag
Берлін	Берлін	LOC	GPE-Berlin
Вашингтоном	Вашингтон	LOC	GPE-WashingtonDC
Газпром	Газпром	ORG	ORG-Gazprom
Газпрому	Газпром	ORG	ORG-Gazprom
Грайфсвальд	Грайфсвальд	LOC	GPE-Greifswald
Економічна правда	Економічна правда	PRO	PRO-Economic-Truth
Коркоран	Коркоран	PER	PER-Paul-Corcoran
Німеччини	Німеччина	LOC	GPE-Germany
Пол Коркоран	Пол Коркоран	PER	PER-Paul-Corcoran
Північний потік-2	Північний потік-2	ORG	ORG-Nord-Stream-2-AG
Північний потік	Північний потік	ORG	ORG-Nord-Stream-AG
Північному потоку	Північний потік	ORG	ORG-Nord-Stream-AG
РФ	РФ	LOC	GPE-Russia
Росія	Росія	LOC	GPE-Russia
Росії	Росія	LOC	GPE-Russia
США	США	LOC	GPE-USA
Усть-Лугу	Усть-Луга	LOC	GPE-Ust-Luga
міністерстві економіки і енергетики	Міністерство економіки і енергетики	ORG	ORG-Federal-Ministry-for-Economic-Affairs-and-Energy-Germany
