ru-192
Dawn	Dawn	ORG	ORG-Dawn-News
REGNUM	REGNUM	ORG	ORG-REGNUM-News-Agency
Асие Биби	Асия Биби	PER	PER-Asia-Bibi
Асии Биби	Асия Биби	PER	PER-Asia-Bibi
Асия Биби	Асия Биби	PER	PER-Asia-Bibi
Биби	Биби	PER	PER-Asia-Bibi
Верховного суда	Верховный суд	ORG	ORG-Supreme-Court-of-Pakistan
Запад	Запад	LOC	LOC-West
Запада	Запад	LOC	LOC-West
Западом	Запад	LOC	LOC-West
Имран Хан	Имран Хан	PER	PER-Imran-Khan
Канады	Канада	LOC	GPE-Canada
Лахоре	Лахор	LOC	GPE-Lahore
Мутахидда Маджлис-э-Амал	Мутахидда Маджлис-э-Амал	ORG	ORG-MMA
Пакистана	Пакистан	LOC	GPE-Pakistan
Пакистаном	Пакистан	LOC	GPE-Pakistan
Пакистану	Пакистан	LOC	GPE-Pakistan
Панджаб	Панджаб	LOC	GPE-Punjab
Рехмана	Рехман	PER	PER-Fazal-ur-Rehman
США	США	LOC	GPE-USA
Фазлур Рехман	Фазлур Рехман	PER	PER-Fazal-ur-Rehman
