ru-147
CNN	CNN	ORG	ORG-CNN
Асии Биби	Асия Биби	PER	PER-Asia-Bibi
Асии	Асия	PER	PER-Asia-Bibi
Асию Биби	Асия Биби	PER	PER-Asia-Bibi
Асию	Асия	PER	PER-Asia-Bibi
Асия Биби	Асия Биби	PER	PER-Asia-Bibi
Асия	Асия	PER	PER-Asia-Bibi
Биби	Биби	PER	PER-Asia-Bibi
Ватикане	Ватикан	LOC	GPE-Vatican
Верховного суда	Верховный суд	ORG	ORG-Supreme-Court-of-Pakistan
Верховный суд Пакистана	Верховный суд Пакистана	ORG	ORG-Supreme-Court-of-Pakistan
Иисуса Христа	Иисус Христос	PER	PER-Jesus-Christ
Иисусу	Иисус	PER	PER-Jesus-Christ
Исламабаде	Исламабад	LOC	GPE-Islamabad
Иттан	Иттан	LOC	GPE-Ittanwali
Кирилл	Кирилл	PER	PER-Kirill-The-Patriarch-of-Moscow-and-all-Ru
Лахоре	Лахор	LOC	GPE-Lahore
Мамнуну Хусейну	Мамнун Хусейн	PER	PER-Mamnoon-Hussain
Мумтаз Кадри	Мумтаз Кадри	PER	PER-Mumtaz-Qadri
Мухаммеда	Мухаммед	PER	PER-Prophet-Muhammad
Мухаммеде	Мухаммед	PER	PER-Prophet-Muhammad
Пакистана	Пакистан	LOC	GPE-Pakistan
Пакистане	Пакистан	LOC	GPE-Pakistan
Пакистане	Пакистане	LOC	GPE-Pakistan
Пенджаб	Пенджаб	LOC	GPE-Punjab
Сакиб Нисар	Сакиб Нисар	PER	PER-Mian-Saqib-Nisar
Салман Тасир	Салман Тасир	PER	PER-Salmaan-Taseer
Тасира	Тасир	PER	PER-Salmaan-Taseer
Техрик-э Лаббейк	Техрик-э Лаббейк	ORG	ORG-Tehreek-e-Labbaik-Pakistan
Франциском	Франциск	PER	PER-Pope-Francis
